AD - Andorra
barýþþþþ
AE - Birleþik Arap Emirlikleri
AF - Afganistan
AG - Antigua ve Barbuda
AI - Anguilla
AL - Arnavutluk
AM - Ermenistan
AO - Angola
AQ - Antarktika
AR - Arjantin
AS - Amerikan Samoasý
AT - Avusturya
AU - Avustralya
AW - Aruba
AZ - Azerbaycan
BA - Bosna-Hersek
BB - Barbados
BD - Bangladeþ
BE - Belçika
BF - Burkina Faso
BG - Bulgaristan
BH - Bahreyn
BI - Burundi
BJ - Benin
BL - Saint Barthelemy
BM - Bermuda
BN - Brunei
BO - Bolivya
BR - Brezilya
BS - Bahamalar
BT - Bhutan
BV - Bouvet Adasý
BW - Botsvana
BY - Beyaz Rusya
BZ - Belize
CA - Kanada
CC - Cocos (Keyling) Adalarý
CD - Demokratik Kongo Cumhuriyeti
CF - Orta Afrika Cumhuriyeti
CG - Kongo Cumhuriyeti
CH - Ýsviçre
CI - Fildiþi Sahili
CK - Cook Adalarý
CL - Þili
CM - Kamerun
CN - Çin
CO - Kolombiya
CR - Kosta Rika
CU - Küba
CV - Yeþil Burun Adalarý
CW - Curaçao
CX - Christmas Adasý
CY - Kýbrýs
CZ - Çek Cumhuriyeti
DE - Almanya
DJ - Cibuti
DK - Danimarka
DM - Dominika
DO - Dominik Cumhuriyeti
DZ - Cezayir
EC - Ekvador
EE - Estonya
EG - Mýsýr
EH - Batý Sahra
ER - Eritre
ES - Ýspanya
ET - Etiyopya
FI - Finlandiya
FJ - Fiji
FK - Falkland Adalarý (Islas Malvinas)
FM - Mikronezya Federal Devletleri
FO - Faroe Adalarý
FR - Fransa
FX - Metropolitan Fransa
GA - Gabon
GB - Birleþik Krallýk
GD - Grenada
GE - Gürcistan
GF - Fransýz Guyanasý
GG - Guernsey
GH - Gana
GI - Cebelitarýk
GL - Grönland
GM - Gambiya
GN - Gine
GP - Guadeloupe
GQ - Ekvator Ginesi
GR - Yunanistan
GS - Güney Georgia ve Güney Sandwich Adalarý
GT - Guatemala
GU - Guam
GW - Gine-Bissau
GY - Guyana
HK - Hong Kong
HM - Heard Adasý ve McDonald Adalarý
HN - Honduras
HR - Hýrvatistan
HT - Haiti
HU - Macaristan
ID - Endonezya
IE - Ýrlanda
IL - Ýsrail
IM - Man Adasý
IN - Hindistan
IO - Britanya Hint Okyanusu Topraklarý
IQ - Irak
IR - Ýran
IS - Ýzlanda
IT - Ýtalya
JE - Jersey
JM - Jamaika
JO - Ürdün
JP - Japonya
KE - Kenya
KG - Kýrgýzistan
KH - Kamboçya
KI - Kiribati
KM - Komorlar
KN - Saint Kitts ve Nevis
KP - Kuzey Kore
KR - Güney Kore
KW - Kuveyt
KY - Cayman Adalarý
KZ - Kazakistan
LA - Laos
LB - Lübnan
LC - Saint Lucia
LI - Lihtenþtayn
LK - Sri Lanka
LR - Liberya
LS - Lesotho
LT - Litvanya
LU - Lüksemburg
LV - Letonya
LY - Libya
MA - Fas
MC - Monako
MD - Moldova
ME - Karadað
MF - Saint Martin
MG - Madagaskar
MH - Marshall Adalarý
MK - Makedonya
ML - Mali
MM - Burma
MN - Moðolistan
MO - Makao
MP - Kuzey Mariana Adalarý
MQ - Martinique
MR - Moritanya
MS - Montserrat
MT - Malta
MU - Mauritius
MV - Maldivler
MW - Malavi
MX - Meksika
MY - Malezya
MZ - Mozambik
NA - Namibya
NC - Yeni Kaledonya
NE - Nijer
NF - Norfolk Adasý
NG - Nijerya
NI - Nikaragua
NL - Hollanda
NO - Norveç
NP - Nepal
NR - Nauru
NU - Niue
NZ - Yeni Zelanda
OM - Umman
PA - Panama
PE - Peru
PF - Fransýz Polinezyasý
PG - Papua Yeni Gine
PH - Filipinler
PK - Pakistan
PL - Polonya
PM - Saint Pierre ve Miquelon
PN - Pitcairn Adalarý
PR - Porto Riko
PS - Gazze
PS - Batý Þeria
PT - Portekiz
PW - Palau
PY - Paraguay
QA - Katar
RE - Reunion
RO - Romanya
RS - Sýrbistan
RU - Rusya
RW - Ruanda
SA - Suudi Arabistan
SB - Solomon Adalarý
SC - Seyþeller
SD - Sudan
SE - Ýsveç
SG - Singapur
SH - Saint Helena, Ascension ve Tristan da Cunha
SI - Slovenya
SJ - Svalbard
SK - Slovakya
SL - Sierra Leone
SM - San Marino
SN - Senegal
SO - Somali
SR - Surinam
SS - Güney Sudan
ST - Sao Tome ve Principe
SV - El Salvador
SX - Saint Martin
SY - Suriye
SZ - Svaziland
TC - Turks ve Caicos Adalarý
TD - Çad
TF - Fransýz Güney ve Antarktik Topraklarý
TG - Togo
TH - Tayland
TJ - Tacikistan
TK - Tokelau
TL - Doðu Timor
TM - Türkmenistan
TN - Tunus
TO - Tonga
TR - Türkiye
TT - Trinidad ve Tobago
TV - Tuvalu
TW - Tayvan
TZ - Tanzanya
UA - Ukrayna
UG - Uganda
UM - Amerika Birleþik Devletleri 
US - Birleþik Devletler
UY - Uruguay
UZ - Özbekistan
VA - Vatikan
VC - Saint Vincent ve Grenadinler
VE - Venezuela
VG - Britanya Virjin Adalarý
VI - Virjin Adalarý
VN - Vietnam
VU - Vanuatu
WF - Wallis ve Futuna
WS - Samoa
XK - Kosova
YE - Yemen
YT - Mayotte
ZA - Güney Afrika
ZM - Zambiya
ZW - Zimbabve